bread | pain | Brot | pan | pane | pão | रोटी | 面包 | хлеб | Brout
cake | gâteau | Kuchen | pastel | torta | bolo | केक | 蛋糕 | торт | Tört
cookie | biscuit | Keks | galleta | biscotto | biscoito | कुकी | 饼干 | печенье | Kéier
pastry | pâte | Gebäck | pastelería | pasta | massa | पेस्ट्री | 糕点 | выпечка | Pascht
roll | petit pain | Brötchen | bollo | panino | pão | रोल | 卷面包 | рулет | Rull
croissant | croissant | Croissant | croissant | cornetto | croissant | क्रोसाँट | 可颂 | круассан | Croissant
donut | beignet | Donut | donut | ciambella | donut | डोनट | 甜甜圈 | пончик | Donut
biscuit | biscuit | Keks | galleta | biscotto | biscoito | बिस्किट | 饼干 | печенье | Biscuit
loaf | miche | Laib | pan | pagnotta | pão | रोटी | 面包 | хлеб | Laib
dough | pâte | Teig | masa | impasto | massa | आटा | 面团 | тесто | Teig
filling | garniture | Füllung | relleno | ripieno | recheio | भरना | 填料 | начинка | Füllung
frosting | glaçage | Frosting | glaseado | glassa | cobertura | आइसिंग | 糖霜 | глазурь | Glaas
jam | confiture | Marmelade | mermelada | marmellata | geléia | जैम | 果酱 | варенье | Konfitur
cream | crème | Sahne | crema | panna | creme | मलाई | 奶油 | сливки | Crème
butter | beurre | Butter | mantequilla | burro | manteiga | मक्खन | 黄油 | масло | Botter
sugar | sucre | Zucker | azúcar | zucchero | açúcar | चीनी | 糖 | сахар | Zucker
flour | farine | Mehl | harina | farina | farinha | आटा | 面粉 | мука | Miel
oven | four | Ofen | horno | forno | forno | ओवन | 烤箱 | духовка | Uewen
baker | boulanger | Bäcker | panadero | panettiere | padeiro | बेकर | 面包师 | пекарь | Bäcker
counter | comptoir | Theke | mostrador | banco | balcão | काउंटर | 柜台 | прилавок | Theker
shelf | étagère | Regal | estante | scaffale | prateleira | शेल्फ | 架子 | полка | Regal
tray | plateau | Tablett | bandeja | vassoio | bandeja | ट्रे | 托盘 | поднос | Plack
plate | assiette | Teller | plato | piatto | prato | प्लेट | 盘子 | тарелка | Plack
warm | chaud | warm | tibio | caldo | morno | गर्म | 温暖 | теплый | waarm
fresh | frais | frisch | fresco | fresco | fresco | ताजा | 新鲜 | свежий | frisch
sweet | doux | süß | dulce | dolce | doce | मीठा | 甜 | сладкий | süß
salty | salé | salzig | salado | salato | salgado | नमकीन | 咸 | солёный | salzig
soft | doux | weich | blando | morbido | macio | मुलायम | 柔软 | мягкий | weich
hard | dur | hart | duro | duro | duro | कठिन | 硬 | твердый | hart
crusty | croûté | knusprig | crujiente | croccante | crocante | कुरकुरी | 酥脆 | корочка | knusprig
crispy | croustillant | knusprig | crujiente | croccante | crocante | कुरकुरी | 脆 | хрустящий | knusprig
slice | tranche | Scheibe | rebanada | fetta | fatia | स्लाइस | 切片 | ломтик | Scheif
bite | mordre | beißen | morder | mordere | morder | काटना | 咬 | укусить | beißen
prepare | préparer | vorbereiten | preparar | preparare | preparar | तैयार करना | 准备 | готовить | preparéieren
mix | mélanger | mischen | mezclar | mescolare | misturar | मिलाना | 混合 | смешивать | mischen
knead | pétrir | kneten | amasar | impastare | amassar | गूँथना | 揉捏 | замесить | kneden
bake | cuire | backen | hornear | cuocere | assar | सेंकना | 烘焙 | печь | baken
serve | servir | servieren | servir | servire | servir | परोसना | 供应 | подавать | déngen
choose | choisir | wählen | elegir | scegliere | escolher | चुनना | 选择 | выбирать | wielen
buy | acheter | kaufen | comprar | comprare | comprar | खरीदना | 买 | купить | kafen
take | prendre | nehmen | tomar | prendere | levar | लेना | 拿 | брать | huelen
order | commander | bestellen | ordenar | ordinare | pedir | आदेश देना | 订单 | заказывать | bestellen
eat | manger | essen | comer | mangiare | comer | खाना | 吃 | есть | iessen
taste | goûter | schmecken | probar | assaporare | saborear | चखना | 尝 | пробовать | schmaachen
smell | sentir | riechen | oler | annusare | cheirar | सूंघना | 闻 | нюхать | rosen
look | regarder | schauen | mirar | guardare | olhar | देखना | 看 | смотреть | kucken
nice | agréable | nett | bonito | bello | agradável | अच्छा | 漂亮 | хороший | schéin
simple | simple | einfach | simple | semplice | simples | सरल | 简单 | простой | einfach
delicious | délicieux | köstlich | delicioso | delizioso | delicioso | स्वादिष्ट | 美味 | вкусный | lecker
popular | populaire | beliebt | popular | popolare | popular | प्रसिद्ध | 流行 | популярный | populär
tasty | savoureux | schmackhaft | sabroso | gustoso | saboroso | स्वादिष्ट | 美味 | вкусный | schmaacht
brown | marron | braun | marrón | marrone | castanho | भूरा | 棕色 | коричневый | brong
white | blanc | weiß | blanco | bianco | branco | सफेद | 白色 | белый | wäiss
round | rond | rund | redondo | rotondo | redondo | गोल | 圆形 | круглый | rund
flat | plat | flach | plano | piatto | plano | चपटा | 平坦 | плоский | flach
large | grand | groß | grande | grande | grande | बड़ा | 大 | большой | grouss
small | petit | klein | pequeño | piccolo | pequeno | छोटा | 小 | маленький | kleng
breakfast | petit déjeuner | Frühstück | desayuno | colazione | café da manhã | नाश्ता | 早餐 | завтрак | Frühstück
snack | collation | Snack | bocadillo | spuntino | lanche | नाश्ता | 小吃 | перекус | Snack
treat | gâter | behandeln | tratar | trattare | tratar | व्यंजन | 款待 | угощение | behandelen
dessert | dessert | Nachtisch | postre | dessert | sobremesa | मिठाई | 甜点 | десерт | Dessert
afternoon | après-midi | Nachmittag | tarde | pomeriggio | tarde | दोपहर | 下午 | день | Mëzzdag
morning | matin | Morgen | mañana | mattina | manhã | सुबह | 早上 | утро | Moien
menu | menu | Speisekarte | menú | menù | menu | मेनू | 菜单 | меню | Menü
customer | client | Kunde | cliente | cliente | cliente | ग्राहक | 客户 | клиент | Client
