deposit | dépôt | Einzahlung | depósito | deposito | depósito | जमा | 存款 | депозит | Depot
deduction | déduction | Abzug | deducción | detrazione | dedução | कटौती | 扣除 | вычет | Abzug
appeal | appel | Berufung | apelación | appello | apelação | अपील | 上诉 | апелляция | Appell
refund | remboursement | Rückerstattung | reembolso | rimborso | reembolso | वापसी | 退款 | возврат | Rückerstattung
statement | relevé | Kontoauszug | estado de cuenta | estratto conto | extrato | विवरण | 报表 | отчет | Auszug
receipt | reçu | Quittung | recibo | ricevuta | recibo | रसीद | 收据 | квитанция | Quittung
dispute | litige | Streit | disputa | controversia | disputa | विवाद | 纠纷 | спор | Streitsache
charge | charge | Gebühr | cargo | addebito | cobrança | शुल्क | 收费 | плата | Gebühr
transaction | transaction | Transaktion | transacción | transazione | transação | लेन-देन | 交易 | транзакция | Transaktion
property | propriété | Eigentum | propiedad | proprietà | propriedade | संपत्ति | 财产 | собственность | Eigentum
tenant | locataire | Mieter | inquilino | inquilino | inquilino | किरायेदार | 租户 | арендатор | Mieter
landlord | propriétaire | Vermieter | propietario | padrone | senhorio | स्वामी | 房东 | арендодатель | Vermieter
evidence | preuve | Beweis | evidencia | prova | evidência | सबूत | 证据 | доказательство | Beweis
agreement | accord | Vereinbarung | acuerdo | accordo | acordo | सहमति | 协议 | соглашение | Vereinbarung
notice | avis | Mitteilung | aviso | avviso | aviso | नोटिस | 通知 | уведомление | Mitteilung
policy | politique | Richtlinie | política | politica | política | नीति | 政策 | политика | Richtlinie
process | processus | Prozess | proceso | processo | processo | प्रक्रिया | 过程 | процесс | Prozess
clarification | clarification | Klärung | aclaración | chiarimento | clarificação | स्पष्टता | 澄清 | разъяснение | Kloerung
documentation | documentation | Dokumentation | documentación | documentazione | documentação | प्रलेखन | 文件 | документация | Dokumentatioun
sign | signe | Zeichen | señal | segnale | sinal | संकेत | 标志 | знак | Zeil
schedule | horaire | Zeitplan | horario | programma | agenda | कार्यक्रम | 日程 | расписание | Zäitplang
communication | communication | Kommunikation | comunicación | comunicazione | comunicação | संचार | 交流 | коммуникация | Kommunikatioun
response | réponse | Antwort | respuesta | risposta | resposta | प्रतिक्रिया | 响应 | ответ | Äntwert
claim | revendication | Anspruch | reclamación | richiesta | reclamação | दावा | 索赔 | требование | Reclamation
review | révision | Überprüfung | revisión | revisione | revisão | समीक्षा | 评审 | обзор | Überpréiwung
balance | équilibre | Gleichgewicht | equilibrio | bilanciamento | saldo | संतुलन | 平衡 | баланс | Balance
account | compte | Konto | cuenta | conto | conta | खाता | 帐户 | счёт | Kont
amount | montant | Betrag | cantidad | importo | quantia | राशि | 数量 | сумма | Betrag
check | vérifier | überprüfen | comprobar | controllare | checar | जांचना | 检查 | проверить | kontrolléieren
terms | conditions | Bedingungen | términos | termini | condições | शर्तें | 条款 | условия | Konditiounen
condition | condition | Zustand | condición | condizione | condição | स्थिति | 条件 | состояние | Condition
rights | droits | Rechte | derechos | diritti | direitos | अधिकार | 权利 | права | Rechter
obligation | obligation | Verpflichtung | obligación | obbligo | obrigação | दायित्व | 义务 | обязательство | Obligation
supporting documents | documents justificatifs | Unterstützungsdokumente | documentos de apoyo | documenti di supporto | documentos de apoio | सहायक दस्तावेज | 支持文件 | сопроводительные документы | Unterstützungsdokumenter
investigation | enquête | Untersuchung | investigación | indagine | investigação | जांच | 调查 | расследование | Untersuchung
meeting | réunion | Sitzung | reunión | incontro | reunião | बैठक | 会议 | встреча | Treffen
issue | problème | Anliegen | problema | questione | questão | मुद्दा | 问题 | вопрос | Thema
resolution | résolution | Resolution | resolución | risoluzione | resolução | समाधान | 解决 | резолюция | Resolutioun
guidance | orientation | Beratung | orientación | guida | orientação | मार्गदर्शन | 指导 | руководство | Orientatioun
proof | preuve | Beweis | prueba | prova | prova | प्रमाण | 证明 | доказательство | Beweis
contact | contact | Kontakt | contacto | contatto | contato | संपर्क | 联系 | контакт | Kontakt
date | date | Datum | fecha | data | data | दिनांक | 日期 | дата | Datum
signature | signature | Unterschrift | firma | firma | assinatura | हस्ताक्षर | 签名 | подпись | Unterschrift
request | demande | Anfrage | solicitud | richiesta | pedido | अनुरोध | 请求 | запрос | Ufrood
decision | décision | Entscheidung | decisión | decisione | decisão | निर्णय | 决定 | решение | Decisioun
reason | raison | Grund | razón | motivo | razão | कारण | 理由 | причина | Grund
error | erreur | Fehler | error | errore | erro | त्रुटि | 错误 | ошибка | Fehler
equality | égalité | Gleichheit | igualdad | uguaglianza | igualdade | समानता | 平等 | равенство | Gleichheet
clarity | clarté | Klarheit | claridad | chiarezza | clareza | स्पष्टता | 清晰度 | ясность | Klarheit
accuracy | précision | Genauigkeit | precisión | accuratezza | precisão | सटीकता | 准确 | точность | Genauigkeit
regulation | réglementation | Vorschrift | regulación | regolamento | regulação | विनियमन | 规定 | регулирование | Regulatioun
confirmation | confirmation | Bestätigung | confirmación | conferma | confirmação | पुष्टि | 确认 | подтверждение | Bestätigung
witness | témoin | Zeuge | testigo | testimone | testemunha | गवाह | 证人 | свидетель | Zeien
testimony | témoignage | Aussage | testimonio | testimonianza | testemunho | गवाही | 证词 | свидетельство | Zeegnis
information | information | Information | información | informazione | informação | जानकारी | 信息 | информация | Informatioun
explanation | explication | Erklärung | explicación | spiegazione | explicação | व्याख्या | 解释 | объяснение | Erklärung
understanding | compréhension | Verständnis | comprensión | comprensione | compreensão | समझ | 理解 | понимание | Verständnis
follow-up | suivi | Nachverfolgung | seguimiento | follow-up | acompanhamento | अनुगमन | 跟进 | последующее | Nachverfolgung
record | enregistrement | Aufzeichnung | registro | registrazione | registro | रिकॉर्ड | 记录 | запись | Aufzeichnung
negotiate | négocier | verhandeln | negociar | negoziare | negociar | बातचीत करना | 谈判 | вести переговоры | verhandeln
resolution process | processus de résolution | Lösungsprozess | proceso de resolución | processo di risoluzione | processo de resolução | समाधान प्रक्रिया | 解决过程 | процесс разрешения | Lösungprozess
settlement | règlement | Einigung | acuerdo | accordo | acordo | सुलह | 和解 | урегулирование | Einigung
review process | processus de révision | Überprüfungsprozess | proceso de revisión | processo di revisione | processo de revisão | समीक्षा प्रक्रिया | 审查过程 | процесс обзора | Überprüfungsprozess
payment plan | plan de paiement | Zahlungsplan | plan de pago | piano di pagamento | plano de pagamento | भुगतान योजना | 付款计划 | план оплаты | Zahlungsplan
financial statement | état financier | Finanzbericht | estado financiero | stato finanziario | demonstração financeira | वित्तीय विवरण | 财务报表 | финансовый отчет | finanziellen Bericht
