overtime | heures supplémentaires | Überstunden | horas extras | straordinario | horas extras | ओवरटाइम | 加班 | сверхурочные | Überstunden
compensation | compensation | Entschädigung | compensación | indennità | compensação | मुआवजा | 补偿 | компенсация | Entschädigung
request | demande | Anfrage | solicitud | richiesta | pedido | अनुरोध | 请求 | запрос | Anfrage
form | formulaire | Formular | formulario | modulo | formulário | फॉर्म | 表格 | форма | Formulaire
hours | heures | Stunden | horas | ore | horas | घंटे | 小时 | часы | Stonnen
approval | approbation | Genehmigung | aprobación | approvazione | aprovação | स्वीकृति | 批准 | одобрение | Genehmegung
manager | responsable | Manager | gerente | manager | gerente | प्रबंधक | 经理 | менеджер | Manager
work | travail | Arbeit | trabajo | lavoro | trabalho | काम | 工作 | работа | Aarbecht
pay | payer | zahlen | pagar | pagare | pagar | भुगतान करना | 支付 | платить | bezuelen
salary | salaire | Gehalt | salario | stipendio | salário | वेतन | 工资 | зарплата | Salär
rate | taux | Satz | tasa | tasso | taxa | दर | 率 | ставка | Tarif
entitlement | droit | Anspruch | derecho | diritto | direito | अधिकार | 权利 | право | Recht
policy | politique | Politik | política | politica | política | नीति | 政策 | политика | Politik
benefits | avantages | Leistungen | beneficios | benefici | benefícios | लाभ | 福利 | преимущества | Virdeeler
agreement | accord | Vereinbarung | acuerdo | accordo | acordo | समझौता | 协议 | соглашение | Accord
department | département | Abteilung | departamento | dipartimento | departamento | विभाग | 部门 | департамент | Departement
additional | supplémentaire | zusätzlich | adicional | aggiuntivo | adicional | अतिरिक्त | 附加的 | дополнительный | zusätzlich
shift | changer | verschieben | cambiar | spostare | mudar | स्थानांतरित करना | 转变 | сдвигать | verschieben
time | temps | Zeit | tiempo | tempo | tempo | समय | 时间 | время | Zäit
document | document | Dokument | documento | documento | documento | दस्तावेज़ | 文件 | документ | Dokument
signature | signature | Unterschrift | firma | firma | assinatura | हस्ताक्षर | 签名 | подпись | Unterschrift
review | réviser | überprüfen | revisar | rivedere | revisar | समीक्षा करना | 复习 | обзор | iwwerpréiwen
project | projet | Projekt | proyecto | progetto | projeto | परियोजना | 项目 | проект | Projet
details | détails | Einzelheiten | detalles | dettagli | detalhes | विवरण | 细节 | детали | Details
claim | déclaration | Anspruch | reclamo | richiesta | reivindicação | दावा | 声明 | заявление | Anspruch
meeting | réunion | Meeting | reunión | incontro | reunião | बैठक | 会议 | встреча | Versammlung
discussion | discussion | Diskussion | discusión | discussione | discussão | चर्चा | 讨论 | обсуждение | Diskussioun
justification | justification | Rechtfertigung | justificación | giustificazione | justificação | औचित्य | 辩护 | обоснование | Rechtfertigung
supporting | soutenir | unterstützen | apoyo | supporto | apoio | समर्थन | 支持 | поддерживающий | unterstützend
evidence | preuve | Beweis | evidencia | prova | evidência | सबूत | 证据 | доказательство | Beweis
documentation | documentation | Dokumentation | documentación | documentazione | documentação | दस्तावेज़ | 文档 | документация | Dokumentatioun
procedure | procédure | Verfahren | procedimiento | procedura | procedimento | प्रक्रिया | 程序 | процедура | Prozedur
guidelines | lignes directrices | Richtlinien | pautas | linee guida | diretrizes | दिशा-निर्देश | 指南 | рекомендации | Richtlinien
submission | soumission | Einreichung | presentación | presentazione | envio | समर्पण | 提交 | подача | Einreichung
deadline | date limite | Frist | fecha límite | scadenza | prazo final | अंतिम तिथि | 最后期限 | крайний срок | Frist
staff | personnel | Mitarbeiter | personal | personale | equipe | कर्मचारी | 员工 | персонал | Personal
requirements | exigences | Anforderungen | requisitos | requisiti | requisitos | आवश्यकताएँ | 要求 | требования | Anforderungen
communication | communication | Kommunikation | comunicación | comunicazione | comunicação | संचार | 通信 | коммуникация | Kommunikation
approach | approche | Ansatz | enfoque | approccio | abordagem | दृष्टिकोण | 方法 | подход | Ansatz
expectation | attente | Erwartung | expectativa | aspettativa | expectativa | अपेक्षा | 期望 | ожидание | Erwartung
acknowledgment | reconnaissance | Anerkennung | reconocimiento | riconoscimento | reconhecimento | स्वीकृति | 确认 | признание | Anerkennung
response | réponse | Antwort | respuesta | risposta | resposta | प्रतिक्रिया | 反应 | ответ | Äntwert
schedule | emploi du temps | Zeitplan | horario | programma | cronograma | कार्यक्रम | 日程 | расписание | Zäitplang
authorization | autorisation | Genehmigung | autorización | autorizzazione | autorização | अनुमति | 授权 | авторизация | Autorisatioun
explanation | explication | Erklärung | explicación | spiegazione | explicação | व्याख्या | 解释 | объяснение | Erklärung
budget | budget | Budget | presupuesto | bilancio | orçamento | बजट | 预算 | бюджет | Budget
allocation | allocation | Zuteilung | asignación | allocazione | alocação | आवंटन | 分配 | распределение | Zuteilung
record | enregistrement | Aufzeichnung | registro | registrazione | registro | रिकॉर्ड | 记录 | запись | Opname
tracking | suivi | Nachverfolgung | seguimiento | tracciamento | rastreamento | ट्रैकिंग | 追踪 | отслеживание | Verfollegung
unit | unité | Einheit | unidad | unità | unidade | इकाई | 单位 | единица | Eenheit
consultation | consultation | Beratung | consulta | consultazione | consulta | परामर्श | 咨询 | консультация | Consultatioun
team | équipe | Team | equipo | squadra | equipe | टीम | 团队 | команда | Equipe
performance | performance | Leistung | rendimiento | prestazione | desempenho | प्रदर्शन | 性能 | производительность | Performance
effort | effort | Anstrengung | esfuerzo | sforzo | esforço | प्रयास | 努力 | усилие | Effort
recognition | reconnaissance | Anerkennung | reconocimiento | riconoscimento | reconhecimento | मान्यता | 认可 | признание | Erkennung
commitment | engagement | Verpflichtung | compromiso | impegno | compromisso | प्रतिबद्धता | 承诺 | обязательство | Engagement
productivity | productivité | Produktivität | productividad | produttività | produtividade | उत्पादन | 生产力 | продуктивность | Produktivité
evaluation | évaluation | Bewertung | evaluación | valutazione | avaliação | मूल्यांकन | 评估 | оценка | Évaluatioun
entitlement | droit | Anspruch | derecho | diritto | direito | हक | 权利 | право | Recht
regulation | régulation | Regulierung | regulación | regolazione | regulação | विनियमन | 规范 | регулирование | Regulatioun
requestor | demandeur | Antragsteller | solicitante | richiedente | requisitante | अनुरोधकर्ता | 请求者 | запрашивающий | Demandant
understanding | compréhension | Verständnis | comprensión | comprensione | compreensão | समझ | 理解 | понимание | Verständnis
impact | impact | Auswirkung | impacto | impatto | impacto | प्रभाव | 影响 | влияние | Impact
acknowledge | reconnaître | anerkennen | reconocer | riconoscere | reconhecer | स्वीकार करना | 承认 | признавать | Anerkennen
feedback | retour | Rückmeldung | retroalimentación | feedback | retorno | प्रतिक्रिया | 反馈 | отзыв | Feedback
